fine = bien
great= genial
drink= bebida
about = acerca de 
beer = cerveza 
would =  haria, gustaria 
could = podria y e el pasado de poder pude
should = deberia
everyone= todos
anyone= alguien
everything= todo
unemployed = deeempleado 
do = hacer 
bread = pan 
dinner = cenar
an= una (cuando empieza por vocal) 
a = un (empieza por consonante )
few = pocos
a few = algunos
think = pensar
little = pequeño
how = como 
old = viejo
how old = cuantos años
letf = izuqierda o depende el contexto es quedarse 
o'clock= en punto 
anymore= ya no
clue= clave o pista
no clue = ni idea
couch = sofa
basement= sotano
bedroom= habitacion
yard= patio
livingroom= sala
backyard= patio tracero 
diningroom= comedor (lugar)
bathroom / restroom = baño
kitchen= cocina
attic= atico
cook=cocinar
belive= creer
jog=trotar
chop= picar
wife=esposa
